111111111111111111111111
10000000000000C100000001
100P00000000111111111111
100000000000C00000000001
111101111000100000000001
10C0C0C010001000C0000E01
100C0C001000100000000001
111111111111111111111111
