1111111111111111111
1000000000000000001
10000000000000C0001
10000P0000000000001
10000000000000000E1
1111111101111111111