1111111111111111111
1000000000000000001
1000P0000000P000001
1000000000000000001
1000000000000C000E1
1111111111111111111
