1111111111111111111
1000000000000000001
1000000001110000001
100C000001P10000001
10E0000001110000001
1111111111111111111
