1111111111111111111
1000000000000000001
1000P000000000X0001
1000000000000000001
1000000000000C000E1
1111111111111111111